1,1,1,1,1,1,1,1,1,1,1,1,
1,0,1,0,0,0,0,0,0,1,5,1,
1,0,1,0,0,0,0,0,0,1,0,1,
1,0,1,0,2,0,0,0,0,1,0,1,
1,0,1,0,0,0,0,2,0,1,0,1,
1,0,1,1,0,9,0,0,0,0,0,1,
1,0,0,0,0,0,0,0,0,0,0,1,
1,0,0,1,0,0,0,2,0,1,0,1,
1,0,0,1,0,0,0,0,0,1,0,1,
1,0,0,1,0,0,0,0,0,1,0,1,
1,4,0,1,0,0,0,0,0,1,0,1,
1,1,1,1,1,1,1,1,1,1,1,1,