1,1,1,1,1,1,1,1,1,1,1,1,
1,0,22,0,0,0,10,0,0,0,0,1,
1,0,2,0,0,0,0,0,2,0,0,1,
1,0,0,0,0,1,1,24,0,0,0,1,
1,0,0,0,0,0,0,1,0,0,0,1,
1,0,0,0,0,4,0,1,0,18,0,1,
1,0,0,0,0,0,0,1,0,0,5,1,
1,0,0,0,1,1,1,0,0,0,0,1,
1,0,2,0,0,0,0,0,2,0,0,1,
1,25,0,0,0,0,0,0,0,0,0,1,
1,0,0,11,0,0,0,0,0,23,0,1,
1,1,1,1,1,1,1,1,1,1,1,1,