1,1,1,1,1,1,1,1,1,1,1,1,
1,20,0,0,1,0,0,0,0,0,0,1,
1,0,0,0,1,0,2,0,0,0,0,1,
1,1,1,0,1,0,0,0,2,0,5,1,
1,4,1,0,0,0,0,0,0,0,0,1,
1,0,1,0,1,0,0,0,0,0,0,1,
1,0,1,0,1,0,0,0,0,0,0,1,
1,0,1,0,1,0,0,0,0,0,0,1,
1,0,1,0,1,0,2,0,0,0,0,1,
1,0,1,0,1,0,0,0,0,0,0,1,
1,0,0,0,1,0,0,0,0,0,11,1,
1,1,1,1,1,1,1,1,1,1,1,1,