1,1,1,1,1,1,1,1,1,1,1,1,
1,0,0,0,0,0,0,0,0,0,15,1,
1,0,0,0,0,0,2,0,0,0,0,1,
1,0,2,0,0,0,0,0,0,0,5,1,
1,0,0,0,16,0,0,0,0,0,0,1,
1,0,1,1,1,0,1,0,0,0,0,1,
1,0,0,0,0,0,0,0,0,2,0,1,
1,0,0,0,0,0,0,0,1,0,0,1,
1,4,0,2,0,0,0,0,0,1,0,1,
1,0,0,0,0,0,0,0,0,0,1,1,
1,0,0,0,0,0,0,0,17,0,0,1,
1,1,1,1,1,1,1,1,1,1,1,1,