1,1,1,1,1,1,1,1,1,1,1,1,
1,1,0,1,0,0,0,0,0,0,0,1,
1,0,0,0,0,2,0,0,0,0,0,1,
1,0,0,0,0,0,0,0,0,0,0,1,
1,4,0,0,0,1,0,0,0,0,0,1,
1,0,0,0,0,1,1,0,0,1,0,1,
1,0,1,0,0,0,0,0,0,1,0,1,
1,0,0,0,0,0,0,0,1,0,0,1,
1,0,0,0,0,0,0,1,0,5,0,1,
1,0,2,0,1,15,1,0,0,0,0,1,
1,0,0,0,0,1,0,12,0,0,0,1,
1,1,1,1,1,1,1,1,1,1,1,1,